11111111111
110001E0001
1000010C0P1
10000000001
11111111111