11111111111
110001E00E1
100001000C1
100000000P1
11111111111