11111111111
110001000E1
10EE01000C1
10EE00000P1
10000000001
11111111111